
1000000
############################
# o#C ##########C #D   # EF#
#A1#  #  #     #  ## # ### #
#s ####        >  D#E#     #
#  #B#>      # #############
# A  #B #  #   #x   F      #
############################
