
100
############
#o     <   #
#      +#  #
#     #++  #
#     #1#  #
#     #s#  #
#      # x #
############
