############################
#+o#Ce##########C<#D   #bEF#
#A+# e#++#++*++#i^##v# ### #
# +####++++++++>  D#E#     #
# +#B#>++++++#+#############
# A  #B+#++#+++#x   F+++++>#
############################