
8
#########
#       #
# #####e#
# #   #e#
#o####x<#
#       #
#########
