
100
#####
#eee#
#h# #
#o# #
# #x#
#   #
#####
