
100
##########
#   ee   #
# o    x #
#        #
##########
