
100
#############################
# vBv   v<E#v<<<I#   #J>v   #
##v^v#  v ^ v ^ ^ ### ^ v ###
#A o C##F A>G#B<H>D<E<I>F<Jx#
##^v^#  ^ v # ^ v ### v   ###
# ^D^   ^<H#  ^<C<<<<<G     #
#############################
