
100
#####
#d  #
#h# #
#o# #
# #x#
#   #
#####
