
100
#############
#Ao+++++3>es#
##v+++s+##As#
#++++##^#####
#+++#++x#####
##3#++++2s++#
#++3+++<++++#
#++++++^++se#
#############
