
100
##################
#o++++++++++++++2#
###############+##
###############x##
##################
