
100
#############
#xo  e      #
#           #
#           #
#############
